0
16
-2
7
00000000000000000
00000000011111110
00000000011111110
00000000011111110
00000000011111110
00000000011111110
00000000011111110
00000000011111110
00000000000000000
00000000001111110
